1111111111
1        1
1        1
1 222    1
1  222  11
1        1
1        1
1  #     1
1        1
1111111 11
111   1 11
1     1 11
1 1   1 11
1 11111 11
1 11111 11
1       11
1111111111
