1111111111
1000000001
1000000001
1011100001
100111001
1000000001
1000000001
100#000001
1000000001
1111111111
