1111111111
1000000001
1000000001
1011100001
1001110011
1000000001
1000000001
100#000001
1000000001
1111111011
1110001011
1000001011
1010001011
1011111011
1011111011
1000000011
1111111111
